NO ./textures/castle_1.xpm
SO ./textures/castle_2.xpm
WE ./textures/castle_3.xpm
EA ./textures/castle_4.xpm

F 33,24,24
C 0,64,128

11111  11111  11111 11111
10001  10001  10001 10001
10001  10001  10001 10001
1011111100111110001110001
1000000000110000000000001
1011000001110000000000001
1001000000000000000000001
11111111101100N0011100001
1000000000110000011101111
1111011111111101110000001
1111011111111101110101001
1100000011010101110000001
1000000000000000110000001
1000000000000000110101001
1100000111010101111101111
1111011111110101110111101
1111111111111111111111111
