NO ./textures/north.xpm
SO ./textures/south.xpm
WE ./textures/west.xpm
EA ./textures/east.xpm

F 50,150,200
C 255,255,0

11111111111111111111111111111111111111111111111111111111111111111111111111111111111111111111111111111111
10000000000000000000000000000000000000000000000000000000000000000000000000000000000000000000000000000001
10111111111111111111111111111111111111111111111111111111111111111111111111111111111111111111111111110001
10100000000000000000000000000000000000000000000000000000000000000000000000000000000000000000000000010001
10101111111111111111111111111111111111111111111111111111111111111111111111111111111111111111111111010001
10101000000000000000000000000000000000000000000000000000000000000000000000000000000000000000000001010001
10101011111111111111111111111111111111111111111111111111111111111111111111111111111111111111111101010001
10101010000000000000000000000000000000000000000000000000000000000000000000000000000000000000000101010001
10101010111111111111111111111111111111111111111111111111111111111111111111111111111111111111110101010001
10101010100000000000000000000000000000000000000000000000000000000000000000000000000000000000001010101001
10101010101111111111111111111111111111111111111111111111111111111111111111111111111111111111101010101001
10101010101000000000000000000000000000000000000000000000000000000000000000000000000000000000101010101001
10101010101011111111111111111111111111111111111111111111111111111111111111111111111111111110101010101001
10101010101010000000000000000000000000000000000000000000000000000000000000000000000000000001010101010101
10101010101010111111111111111111111111111111111111111111111111111111111111111111111111111101010101010101
10101010101010100000000000000000000000000000000000000000000000000000000000000000000000000101010101010101
10101010101010101111111111111111111111111111111111111111111111111111111111111111111111110101010101010101
10101010101010101000000000000000000000000000000000000000000000000000000000000000000000001010101010101001
10101010101010101011111111111111111111111111111111111111111111111111111111111111111111101010101010101001
10101010101010101010000000000000000000000000000000000000000000000000000000000000000000101010101010101001
10101010101010101010111111111111111111111111111111111111111111111111111111111111111110101010101010101001
10101010101010101010100000000000000000000000000000000000000000000000000000000000000001010101010101010101
10101010101010101010101111111111111111111111111111111111111111111111111111111111111101010101010101010101
101010101010101010101010000000000000000000000000000000000000000000000000000000000000010101010101010101S1
10101010101010101010101111111111111111111111111111111111111111111111111111111111111101010101010101010101
10101010101010101010100000000000000000000000000000000000000000000000000000000000000001010101010101010101
10101010101010101010111111111111111111111111111111111111111111111111111111111111111110101010101010101001
10101010101010101010000000000000000000000000000000000000000000000000000000000000000000101010101010101001
10101010101010101011111111111111111111111111111111111111111111111111111111111111111111101010101010101001
10101010101010101000000000000000000000000000000000000000000000000000000000000000000000001010101010101001
10101010101010101111111111111111111111111111111111111111111111111111111111111111111111110101010101010101
10101010101010100000000000000000000000000000000000000000000000000000000000000000000000000101010101010101
10101010101010111111111111111111111111111111111111111111111111111111111111111111111111111101010101010101
10101010101010000000000000000000000000000000000000000000000000000000000000000000000000000001010101010101
10101010101011111111111111111111111111111111111111111111111111111111111111111111111111111110101010101001
10101010101000000000000000000000000000000000000000000000000000000000000000000000000000000000101010101001
10101010101111111111111111111111111111111111111111111111111111111111111111111111111111111111101010101001
10101010100000000000000000000000000000000000000000000000000000000000000000000000000000000000001010101001
10101010111111111111111111111111111111111111111111111111111111111111111111111111111111111111110101010001
10101010000000000000000000000000000000000000000000000000000000000000000000000000000000000000000101010001
10101011111111111111111111111111111111111111111111111111111111111111111111111111111111111111111101010001
10101000000000000000000000000000000000000000000000000000000000000000000000000000000000000000000001010001
10101111111111111111111111111111111111111111111111111111111111111111111111111111111111111111111111010001
10100000000000000000000000000000000000000000000000000000000000000000000000000000000000000000000000010001
10111111111111111111111111111111111111111111111111111111111111111111111111111111111111111111111111110001
10000000000000000000000000000000000000000000000000000000000000000000000000000000000000000000000000000001
11111111111111111111111111111111111111111111111111111111111111111111111111111111111111111111111111111111
