NO ./textures/north.xpm
SO ./textures/south.xpm
WE ./textures/west.xpm
EA ./textures/east.xpm

F 255,255,255
C 0,0,0

1111111111
1000000001
1000100001
1000100001
1000100001
1000000001
1000100001
1000100001
1000100001
100000000N
1111111111
