NO ./textures/interrogation.xpm
SO ./textures/crack_wall.xpm
WE ./textures/brick_wall.xpm
EA ./textures/3dwall.xpm

F 21,100,0
C 80,143,245

11111111111111111111111111111111
10000000000000000000000000000001
10000000111000011100000011000001
100000001110S0011100000011000001
10000000000000000000000000000001
11111000000111000000000000111111
    10000001110000000000001
    10000000000000011100001
    10000000000000011100001
    10000000000000000000001
    11111111111111111111111
