NO ./textures/NO.xpm
SO ./textures/south.xpm
WE ./textures/west.xpm
EA ./textures/NO.xpm

F 128,64,32
C 135,206,235


11111111111111111111111111111111111111111111111111111111111111111111111111111111111111111111111111111111111111111111111111111111111111111111111111111111111111111111111111111111111111111111111111111111111111111111111111111111111111111111111111111111111111111111111111111111111111111111111111111
111111111111111111111111111111111111111111111111111111111111111111111111111111111111111111111111111111111111111111111111111111111111111111111111111111111111111111111111111111111111111111111111111111111111111111111111111111111111111111111111111111111111111111111111111111               111
1                                                                                                                                                  1000000000000000000000000000000000000000000000000000000000000000000000000000000000000000000000000000000000000000000000000011                11
111111111111111111111111111111111111111111111111111111111111111111111111111111111111111111111111111111111111111111111111111111111111111111111111111111111111111111111111111111111111111111111111111111111111111111111111111111111111111111111111111111111111111111111111111111                 01
1                                           1                                          11                                                                                                                                                                                                      11
1                                                                                                                                                                                                                                                                                              1
11111111111111111111111111111111111111111111111111111111111111111111111111111111111111111111111111111111111111111111111111111111111111111111111111111                                                                                                                                          1
10000000000000000000000000000000000000000000000000000000000000001  1000000000000000000000000000000000000000000000000000000000000000000000000000000001                                                                                                                                          1
11111111111111111111111111111111111111111111111111111111111111111111111111111111111111111111111111111111111111111111111111111111111111111111111111111                                                                                                                                          1
1N1                                                                                                                                                                                                                                                                                           111
11111111111111111111111111111111111111111111111111111111111111111111111111111111111111111111111111111111111111111111111111111111111111111111111111111111111111111111111111111111111111111111111111111111111111111111111111111111111111111111111111111111111111111111111111111111111111111111111111111111111111111111
