SO ./path_to_the_south_texture./path_to_the_south_texture
NO ./path_to_the_north_texture
WE         ./path_to_the_west_texture
EA ./path_to_the_east_texture
F 220,100,0
C 225,30,0

1111111111111111111111111111111111111111111111111111111111111
10000000000000000000000000000000000000000000000000001
101100000000000000000000000000000000000000000010000011
100100000000000000101100111000000000000000000000001111
11111111101100000000000000000000000000000000000000000011
10000000001100000000000N000000000000011111110000000000011
10000000001100000000000000000000000000000000000000001111
10110000000000000000000000000000000000000000001000001
100100000000000000000000000000011111111111100000000001111
11111111101100000000000000000000000000000000000000000011
100000000011000000000000000000000000011111110000000000011
10000000001100000000000000000000000000000000000000001111
10110000000000000000000000000000000000000000001000001
100100000000000000000000000000011111111111100000000001111
11111111101100000000000000000000000000000000000000000011
100000000011000000000000000000000000011111110000000000011
10000000001100000000000000000000000000000000000000001111
10110000000000000000000000000000000000000000001000001
100100000000000000000000000000011111111111100000000001111
11111111101100000000000000000000000000000000000000000011
100000000011000000000000000000000000011111110000000000011
11111111111111111111111111111111111111111111111111111111111111111111111111111
