SO ./path_to_the_south_texture./path_to_the_south_texture
NO ./textures/NO.xpm
WE         ./path_to_the_west_texture
EA ./path_to_the_east_texture
F 220,100,0
C 0,220,100

1111111111111111111111111111111111111111111111111111111111111
10000000000000000000000000000000000000000000000000001
101100000000000000000000000000000000000000000010000011
1001000000000000001011001110000000000000000000000011111
11111111101100000000000000000000000000000000000000000011
100000000011000000000000000000000000011111110000000000011
1000000000110000000000000000000E000000000000000000001111
101100000000000000000000000000000000000000000010000011
110100000000000000000000000000011111111111100000000001111
 11111111101100000000000001110000000000000000000000000011
11000000001100000000000011 100000000011111110000000000011
1000000000110000000000001 110000000000000000000000001111
10110000000000000000000011110000000000000000000010000011
111100000000000000000000000000011111111111100000000001111
111111111101100011111000000000000000000000000000000000011
11110000001100001   1000000000000000011111110000000000011
10000000001100001111100000000000000000000000000000001111
101100000000000000000000000000000000000000000010000011
100100000000000000000000000000011111111111100000000001111
11111111101100000000000000000000000000000000000000000011
100000000011000000000000000000000000011111110000000000011
111111111111111111111111111111111111111111111111111111111
