SO ./textures/SO.xpm
NO ./textures/NO.xpm
WE ./textures/WE.xpm
EA ./textures/EA.xpm
F 128,128,128
C 173,216,230

11111111111111111111111111111111111111111111111111111111111111111111111
10000000000000000000000000000000000000000000000000001                 1
101100000000000000000000000000000000000000000010000011                1
100100000000000000101100111000000000000N000000000011111               1
111111111011000000000000000000000000000000000000000000111             1
10000000001100000000000000000000000001111111000000000001111111111111111
100000000011000000000000000000000001000000000000000001111
101100000000000000000000000000000010000000000010000011
110100000000000000000000000000011111111111100000000001111
 1111111110110000000000001110000000000000000000000000011
11000000001100000000000011 100000000011111110000000000011
10000000001100000000000011110000000000000000000000001111
10110000000000000000000011110000000000000000000010000011
111100000000000000000000000000011111111111100000000001111
11111111110110001111100000000000000000000000000000000011
11110000001100001   1000000000000000011111110000000000011
10000000001100001111100000000000000000000000000000001111
101100000000000000000000000000000000000000000100000111
10010000000000000000000000000001111111111110000000001111
111111111011000000000000000000000000000000000000000000011
10000000011000000000000000000000000011111110000000000011
11111111111111111111111111111111111111111111111111111111
