SO ./textures/south.xpm
NO ./textures/north.xpm
WE ./textures/west.xpm
EA ./textures/east.xpm
F 128,128,128
C 173,216,230

1111111111111111111111111111111111111111111111111111111111111
10000000000000000000000000000000000000000000000000001
101100000000000000000000000000000000000000000010000011
1001000000000000001011001110000000000000000000000011111
111111111011000000000000000000000000000N0000000000000011
100000000011000000000000000000000000011111110000000000011
100000000011000000000000000000000001000000000000000001111
101100000000000000000000000000000010000000000010000011
110100000000000000000000000000011111111111100000000001111
 1111111110110000000000001110000000000000000000000000011
11000000001100000000000011 100000000011111110000000000011
10000000001100000000000011110000000000000000000000001111
10110000000000000000000011110000000000000000000010000011
111100000000000000000000000000011111111111100000000001111
11111111110110001111100000000000000000000000000000000011
11110000001100001   1000000000000000011111110000000000011
10000000001100001111100000000000000000000000000000001111
101100000000000000000000000000000000000000000100000111
10010000000000000000000000000001111111111110000000001111
111111111011000000000000000000000000000000000000000000011
10000000011000000000000000000000000011111110000000000011
11111111111111111111111111111111111111111111111111111111
