NO ./path_to_the_north_texture
SO ./path_to_the_south_texture
WE ./path_to_the_west_texture
EA ./path_to_the_east_texture
F 220,100,0
C 225,30,0
0011111111111111111111111
10000000001100000000000011111111
1011000001110000000000000000001
1001000000000000000000001110111
11111111101100000110000000000001
100000000011000001100111111111111
1111111111111111111011111111
11110111111111 11100000010001
11110111111111111101010010001111111
11000000110101011100000010001
111111111000000000000000001111111111111
100000000000000011010100000000000000001
11000001110101011101011110N011111111111
11110111 1110101 101111010001
11111111 1111111 111111111111
