                          C 225,130,0


SO ./path_to_the_south_texture./path_to_the_south_texture
NO ./path_to_the_north_texture
F 220,100,0
WE         ./path_to_the_west_texture
EA ./path_to_the_east_texture



111111111111111111111111111
100000000000000000000000001
110011111111111111111111111
10000000000000000001111111111
10000000000000N000000001111
1111111111000000110000000011
100000000000000000000000011
11111000000001110000000000011
100000000000000111111111111
110000000000011111111111
1100000000000001111111111
111111111111110000000000011
1111111111111111111111111111
