NO ./textures/NO.xpm
SO ./textures/south.xpm
WE ./textures/west.xpm
EA ./textures/NO.xpm

F 128,64,32
C 135,206,235


11111111111111111111111111111111111111111111111111111111111111111111111111111111111111111111111111111111111111111111111111111111111111111111111111111111111111111111111111111111111111111111111111111111111111111111111111111111111111111111111111111111111111111111111111111111111111111111111111111
1111111111111111111111111111111111111111111111111111111111111111111111111111111111111111111111111111111111111111111111111111111111111111111111111111                                                                                                                         11                
1                                                                                                                                                  1000000000000000000000000000000000000000000000000000000000000000000000000000000000000000000000000000000000000000000000000011                11
1111111111111111111111111111111111111111111111111111111111111111111111111111111111111111111111111111111111111111111111111111111111111111111111111111                                                                                                                                           01
1                                           1                                          11                                                                                                                                                                                                      11
1                                                                                                                                                                                                                                                                                              1
11111111111111111111111111111111111111111111111111111111111111111111111111111111111111111111111111111111111111111111111111111111111111111111111111111                                                                                                                                          1
100000000000000000000000000000000000000000000000000000000000000000  000000000000000000000000000000000000000000000000000000000000000000000000000000001                                                                                                                                          1
11111111111111111111111111111111111111111111111111111111111111111111111111111111111111111111111111111111111111111111111111111111111111111111111111111                                                                                                                                          1
1N1                                                                                                                                                                                                                                                                                           111
11111111111111111111111111111111111111111111111111111111111111111111111111111111111111111111111111111111111111111111111111111111111111111111111111111111111111111111111111111111111111111111111111111111111111111111111111111111111111111111111111111111111111111111111111111111111111111111111111111111111111111111